==========
=O========
=--=======
=--=======
=--------=
=-----H--=
=--------=
=-------==
=------===
==========